blue: 0,A
red: 1,B
green: 2,C
+++++++++++
+0       2+
+  ccccc  +
+  cBBBc  +
+  cBaBc  +
+  cBBBc  +
+  ccccc  +
+         +
+++++ +++++
+         +
+  CCCCC  +
+  CbbbC  +
+  CbAbC  +
+  CbbbC  +
+  CCCCC  +
+         +
+++++1+++++
    +++