+++++++++++
+0        +
+  ccccc  +
+  cBBBc  +
+  cBaBc  +
+  cBBBc  +
+  ccccc  +
+         +
+         +
+  CCCCC  +
+  CbbbC  +
+  CbAbC  +
+  CbbbC  +
+  CCCCC  +
+         +
+++++++++++
