++++++++++++
+          +
+    a  0  +
+          +
++++++++++ +
         + +
         +b+
         + +
++++++++++ +
+          +
+    B     +
+    A     +
+          +
++++++++++++
