+++++++++++++
+          a+
+           +
+           +
+     A     +
+           +
+   A 0 A   +
+           +
+     A     +
+           +
+           +
+           +
+++++++++++++
