++++++++++++++++++++++++
+                      +
+0Aa                   +
+                      +
+                      +
+        +++           +
+       ++aAA+++++++++++
++++++++++++++