++++++++++++++++++++++++
+   Bb                 +
+0                     +
+                      +
+                      +
+        +++           +
+       ++aBA+++++++++++
++++++++++++++