blue: 0,A
red: 1,B
yellow: 2,C
green: 3,D
++++++++++++
+ c++++++a +
+A  ++++  C+
+   2103   +
+D  ++++  B+
+ b++++++d +
++++++++++++
